1111111111
1000000001
1111100001
1000000001
1000000001
1000000001
1011100001
1000000001
1010000001
1011111001
1000000001
1001000$01
1000000001
1000000001
1111111111
